NO                           ./media/textures/eagle.xpm
SO ./media/textures/stone.xpm
WE          ./media/textures/wall2.xpm
EA                      ./media/textures/wall.xpm

F                    70,130,180
C                    210,105,30

        1111111111111111111111111
        1000000000110000000000001
        1011000E01110000000000001
        1001000000000000000W00001
111111111011000001110000000000001
100000000011000001110111111111111
11110111111111011100000010001
111101N1111111011101010010001
11000000110101011100000010001
10000000000000001100000010001
10000000000000001101010010001
11000001110101011111011110S0111
11110111 1110101 101111010001
11111111 1111111 111111111111
