NO ./media/textures/wall.xpm
SO ./media/textures/wall2.xpm
WE ./media/textures/stone.xpm
EA ./media/textures/eagle.xpm

F 70,130,180
C 210,105,30

1111111111111111111111111
1000000000110000000000001
10110000011100N0000000001
1001000000000000000000001
1111111110110000011100001
1000000000110000011101111
1111011111111101110000001
1111011111111101110101001
1100000011010101110000001
1000000000000000110000001
1000000000000000110101001
1100000111010101111101111
11110111 1110101 10111101
11111111 1111111 11111111
